// Level (STAGE 0)
00 01 00 01 00 01 00 01 00 01 00 01 00 01 00 01 00 01 00 01 
02 02 02 02 02 02 02 02 02 02 02 02 02 02 02 02 02 02 02 02  
03 03 03 03 03 03 03 03 03 03 03 03 03 03 03 03 03 03 03 03 
04 05 06 04 05 06 04 05 06 04 05 06 04 05 06 04 05 06 04 05 
07 07 07 07 07 07 07 07 07 07 07 07 07 07 07 07 07 07 07 07 
08 08 08 08 08 08 08 08 08 08 08 08 08 08 08 08 08 08 08 08 
08 08 08 08 08 08 08 08 08 08 08 08 08 08 08 08 08 08 08 08 
08 08 08 08 08 08 08 08 08 08 08 08 08 08 08 08 08 08 08 08 
08 08 08 08 08 08 08 08 08 08 08 08 08 08 08 08 08 08 08 08 
09 09 09 09 09 09 09 09 09 09 09 09 09 09 09 09 09 09 09 09 
0A 0A 0A 0A 0A 0A 0A 0A 0A 0A 0A 0A 0A 0A 0A 0A 0A 0A 0A 0A 
0A 0A 0A 0A 0A 0A 0A 0A 0A 0A 0A 0A 0A 0A 0A 0A 0A 0A 0A 0A 
0A 0A 0A 0A 0A 0A 0A 0A 0A 0A 0A 0A 0A 0A 0A 0A 0A 0A 0A 0A 
0B 0B 0B 0B 0B 0B 0B 0B 0B 0B 0B 0B 0B 0B 0B 0B 0B 0B 0B 0B 
0C 0C 0C 0C 0C 0C 0C 0C 0C 0C 0C 0C 0C 0C 0C 0C 0C 0C 0C 0C 

// Shop (STAGE 1)
02 02 02 02 02 02 02 02 02 02 02 02 02 02 02 02 02 02 02 02 
02 02 02 02 02 02 02 02 02 02 02 02 02 02 02 02 02 02 02 02 
02 02 02 02 02 02 02 02 02 02 02 02 02 02 02 02 02 02 02 02 
02 02 02 02 02 02 02 02 02 02 02 02 02 02 02 02 02 02 02 02 
02 02 02 02 02 02 02 02 02 02 02 02 02 02 02 02 02 02 02 02 
02 02 02 02 02 02 02 02 02 02 02 02 02 02 02 02 02 02 02 02 
02 02 02 02 02 02 02 02 02 02 02 02 02 02 02 02 02 02 02 02 
02 02 02 02 02 02 02 02 02 02 02 02 02 02 02 02 02 02 02 02 
02 02 02 02 02 02 02 02 02 02 02 02 02 02 02 02 02 02 02 02 
02 02 02 02 02 02 02 02 02 02 02 02 02 02 02 02 02 02 02 02 
02 02 02 02 02 02 02 02 02 02 02 02 02 02 02 02 02 02 02 02 
02 02 02 02 02 02 02 02 02 02 02 02 02 02 02 02 02 02 02 02 
02 02 02 02 02 02 02 02 02 02 02 02 02 02 02 02 02 02 02 02 
02 02 02 02 02 02 02 02 02 02 02 02 02 02 02 02 02 02 02 02 
02 02 02 02 02 02 02 02 02 02 02 02 02 02 02 02 02 02 02 02 

// Win Menu (STAGE 2)
02 02 08 08 08 08 08 08 08 08 08 08 08 08 08 08 08 08 02 02
02 02 08 08 08 08 08 08 08 08 08 08 08 08 08 08 08 08 02 02
02 02 08 08 08 08 08 08 08 08 08 08 08 08 08 08 08 08 02 02
02 02 08 08 08 08 08 08 08 08 08 08 08 08 08 08 08 08 02 02
02 02 08 08 08 08 08 08 08 08 08 08 08 08 08 08 08 08 02 02
02 02 08 08 08 08 08 08 08 08 08 08 08 08 08 08 08 08 02 02
02 02 08 08 08 08 08 08 08 08 08 08 08 08 08 08 08 08 02 02
02 02 08 08 08 08 08 08 08 08 08 08 08 08 08 08 08 08 02 02
02 02 08 08 08 08 08 08 08 08 08 08 08 08 08 08 08 08 02 02
02 02 08 08 08 08 08 08 08 08 08 08 08 08 08 08 08 08 02 02
02 02 08 08 08 08 08 08 08 08 08 08 08 08 08 08 08 08 02 02
02 02 08 08 08 08 08 08 08 08 08 08 08 08 08 08 08 08 02 02
02 02 08 08 08 08 08 08 08 08 08 08 08 08 08 08 08 08 02 02
02 02 08 08 08 08 08 08 08 08 08 08 08 08 08 08 08 08 02 02
02 02 08 08 08 08 08 08 08 08 08 08 08 08 08 08 08 08 02 02

// Loss Menu (STAGE 3)
08 08 02 02 02 02 02 02 02 02 02 02 02 02 02 02 02 02 08 08
08 08 02 02 02 02 02 02 02 02 02 02 02 02 02 02 02 02 08 08
08 08 02 02 02 02 02 02 02 02 02 02 02 02 02 02 02 02 08 08
08 08 02 02 02 02 02 02 02 02 02 02 02 02 02 02 02 02 08 08
08 08 02 02 02 02 02 02 02 02 02 02 02 02 02 02 02 02 08 08
08 08 02 02 02 02 02 02 02 02 02 02 02 02 02 02 02 02 08 08
08 08 02 02 02 02 02 02 02 02 02 02 02 02 02 02 02 02 08 08
08 08 02 02 02 02 02 02 02 02 02 02 02 02 02 02 02 02 08 08
08 08 02 02 02 02 02 02 02 02 02 02 02 02 02 02 02 02 08 08
08 08 02 02 02 02 02 02 02 02 02 02 02 02 02 02 02 02 08 08
08 08 02 02 02 02 02 02 02 02 02 02 02 02 02 02 02 02 08 08
08 08 02 02 02 02 02 02 02 02 02 02 02 02 02 02 02 02 08 08
08 08 02 02 02 02 02 02 02 02 02 02 02 02 02 02 02 02 08 08
08 08 02 02 02 02 02 02 02 02 02 02 02 02 02 02 02 02 08 08
08 08 02 02 02 02 02 02 02 02 02 02 02 02 02 02 02 02 08 08

// Main Menu (STAGE 4)
02 02 02 02 02 02 02 02 02 02 02 02 02 02 02 02 02 02 02 02  
02 02 02 02 02 02 02 02 02 02 02 02 02 02 02 02 02 02 02 02 
02 02 08 08 08 08 08 08 08 08 08 08 08 08 08 08 08 08 02 02
02 02 08 08 08 08 08 08 08 08 08 08 08 08 08 08 08 08 02 02
02 02 08 08 08 08 08 08 08 08 08 08 08 08 08 08 08 08 02 02
02 02 08 08 08 08 08 08 08 08 08 08 08 08 08 08 08 08 02 02
02 02 08 08 08 08 08 08 08 08 08 08 08 08 08 08 08 08 02 02
02 02 08 08 08 08 08 08 08 08 08 08 08 08 08 08 08 08 02 02
02 02 08 08 08 08 08 08 08 08 08 08 08 08 08 08 08 08 02 02
02 02 08 08 08 08 08 08 08 08 08 08 08 08 08 08 08 08 02 02
02 02 08 08 08 08 08 08 08 08 08 08 08 08 08 08 08 08 02 02
02 02 08 08 08 08 08 08 08 08 08 08 08 08 08 08 08 08 02 02
02 02 08 08 08 08 08 08 08 08 08 08 08 08 08 08 08 08 02 02
02 02 02 02 02 02 02 02 02 02 02 02 02 02 02 02 02 02 02 02 
02 02 02 02 02 02 02 02 02 02 02 02 02 02 02 02 02 02 02 02 

// Game End (STAGE 5)
02 08 08 08 08 08 08 08 08 08 08 08 08 08 08 08 08 08 08 08
08 02 02 08 08 08 08 08 08 08 08 08 08 08 08 08 08 08 08 08
08 08 08 02 08 08 08 08 08 08 08 08 08 08 08 08 08 08 08 08
08 08 08 08 02 08 08 08 08 08 08 08 08 08 08 08 08 08 08 08
08 08 08 08 08 02 08 08 08 08 08 08 08 08 08 08 08 08 08 08
08 08 08 08 08 08 02 08 08 08 08 08 08 08 08 08 08 08 08 08
08 08 08 08 08 08 08 02 08 08 08 08 08 08 08 08 08 08 08 08
08 08 08 08 08 08 08 08 02 08 08 08 08 08 08 08 08 08 08 08
08 08 08 08 08 08 08 08 08 02 02 08 08 08 08 08 08 08 08 08
08 08 08 08 08 08 08 08 08 08 08 02 02 08 08 08 08 08 08 08
08 08 08 08 08 08 08 08 08 08 08 08 08 02 02 08 08 08 08 08
08 08 08 08 08 08 08 08 08 08 08 08 08 08 08 02 08 08 08 08
08 08 08 08 08 08 08 08 08 08 08 08 08 08 08 08 02 08 08 08
08 08 08 08 08 08 08 08 08 08 08 08 08 08 08 08 08 02 02 08
08 08 08 08 08 08 08 08 08 08 08 08 08 08 08 08 08 08 08 02
