// Main Menu (STAGE 0)
00 01 00 01 00 01 00 01 00 01 00 01 00 01 00 01 00 01 00 01 
02 02 02 02 02 02 02 02 02 02 02 02 02 02 02 02 02 02 02 02  
03 03 03 03 03 03 03 03 03 03 03 03 03 03 03 03 03 03 03 03 
04 05 06 04 05 06 04 05 06 04 05 06 04 05 06 04 05 06 04 05 
07 07 07 07 07 07 07 07 07 07 07 07 07 07 07 07 07 07 07 07 
08 08 08 08 08 08 08 08 08 08 08 08 08 08 08 08 08 08 08 08 
08 08 08 08 08 08 08 08 08 08 08 08 08 08 08 08 08 08 08 08 
08 08 08 08 08 08 08 08 08 08 08 08 08 08 08 08 08 08 08 08 
08 08 08 08 08 08 08 08 08 08 08 08 08 08 08 08 08 08 08 08 
09 09 09 09 09 09 09 09 09 09 09 09 09 09 09 09 09 09 09 09 
0A 0A 0A 0A 0A 0A 0A 0A 0A 0A 0A 0A 0A 0A 0A 0A 0A 0A 0A 0A 
0A 0A 0A 0A 0A 0A 0A 0A 0A 0A 0A 0A 0A 0A 0A 0A 0A 0A 0A 0A 
0A 0A 0A 0A 0A 0A 0A 0A 0A 0A 0A 0A 0A 0A 0A 0A 0A 0A 0A 0A 
0B 0B 0B 0B 0B 0B 0B 0B 0B 0B 0B 0B 0B 0B 0B 0B 0B 0B 0B 0B 
0C 0C 0C 0C 0C 0C 0C 0C 0C 0C 0C 0C 0C 0C 0C 0C 0C 0C 0C 0C 



